,Title,ff,mf,mm,Total,ff_percent,mf_percent,mm_percent
0,10 Things I Hate About You,30,102,69,201,0.14925373134328357,0.5074626865671642,0.34328358208955223
1,1492: Conquest Of Paradise,0,0,93,93,0.0,0.0,1.0
2,15 Minutes,0,30,148,178,0.0,0.16853932584269662,0.8314606741573034
3,2001: A Space Odyssey,0,0,73,73,0.0,0.0,1.0
4,48 Hrs.,0,32,149,181,0.0,0.17679558011049723,0.8232044198895028
5,8Mm,0,14,115,129,0.0,0.10852713178294573,0.8914728682170543
6,A Bucket Of Blood,0,70,86,156,0.0,0.44871794871794873,0.5512820512820513
7,A Clockwork Orange,0,3,70,73,0.0,0.0410958904109589,0.958904109589041
8,A Hard Day'S Night,0,9,154,163,0.0,0.05521472392638037,0.9447852760736196
9,A Nightmare On Elm Street,24,57,11,92,0.2608695652173913,0.6195652173913043,0.11956521739130435
10,A Nightmare On Elm Street 3: Dream Warriors,14,52,27,93,0.15053763440860216,0.5591397849462365,0.2903225806451613
11,A Nightmare On Elm Street 4: The Dream Master,0,37,15,52,0.0,0.7115384615384616,0.28846153846153844
12,A Nightmare On Elm Street Part 2: Freddy'S Revenge,0,54,34,88,0.0,0.6136363636363636,0.38636363636363635
13,A Nightmare On Elm Street: The Dream Child,20,60,5,85,0.23529411764705882,0.7058823529411765,0.058823529411764705
14,A Walk To Remember,0,128,50,178,0.0,0.7191011235955056,0.2808988764044944
15,Affliction,0,37,78,115,0.0,0.3217391304347826,0.6782608695652174
16,Agnes Of God,82,17,0,99,0.8282828282828283,0.1717171717171717,0.0
17,Air Force One,0,0,130,130,0.0,0.0,1.0
18,Airplane Ii: The Sequel,0,45,38,83,0.0,0.5421686746987951,0.4578313253012048
19,Airplane!,0,33,45,78,0.0,0.4230769230769231,0.5769230769230769
20,Alien,0,0,234,234,0.0,0.0,1.0
21,Alien Nation,0,0,103,103,0.0,0.0,1.0
22,Alien Vs. Predator,0,0,106,106,0.0,0.0,1.0
23,Aliens,20,76,38,134,0.14925373134328357,0.5671641791044776,0.2835820895522388
24,All About Eve,93,162,12,267,0.34831460674157305,0.6067415730337079,0.0449438202247191
25,All The President'S Men,0,7,156,163,0.0,0.04294478527607362,0.9570552147239264
26,Amadeus,0,61,162,223,0.0,0.273542600896861,0.726457399103139
27,American Madness,2,44,105,151,0.013245033112582781,0.2913907284768212,0.695364238410596
28,American Outlaws,0,21,183,204,0.0,0.10294117647058823,0.8970588235294118
29,American Pie,3,60,140,203,0.014778325123152709,0.2955665024630542,0.6896551724137931
30,American Psycho,0,60,100,160,0.0,0.375,0.625
31,An American Werewolf In London,0,51,75,126,0.0,0.40476190476190477,0.5952380952380952
32,An American Werewolf In Paris,0,53,84,137,0.0,0.38686131386861317,0.6131386861313869
33,An Officer And A Gentleman,11,51,75,137,0.08029197080291971,0.3722627737226277,0.5474452554744526
34,Anastasia,0,51,43,94,0.0,0.5425531914893617,0.4574468085106383
35,Annie Hall,0,134,62,196,0.0,0.6836734693877551,0.3163265306122449
36,Antitrust,0,68,82,150,0.0,0.4533333333333333,0.5466666666666666
37,Antz,0,42,52,94,0.0,0.44680851063829785,0.5531914893617021
38,Apocalypse Now,0,0,162,162,0.0,0.0,1.0
39,Arcade,0,83,17,100,0.0,0.83,0.17
40,Arctic Blue,0,27,124,151,0.0,0.17880794701986755,0.8211920529801324
41,As Good As It Gets,5,86,72,163,0.03067484662576687,0.5276073619631901,0.44171779141104295
42,Assassins,0,61,67,128,0.0,0.4765625,0.5234375
43,Asylum,0,0,196,196,0.0,0.0,1.0
44,Austin Powers: International Man Of Mystery,0,49,68,117,0.0,0.4188034188034188,0.5811965811965812
45,Bachelor Party,0,32,114,146,0.0,0.2191780821917808,0.7808219178082192
46,Back To The Future,0,0,113,113,0.0,0.0,1.0
47,Backdraft,0,33,117,150,0.0,0.22,0.78
48,Bad Lieutenant,0,14,26,40,0.0,0.35,0.65
49,Badlands,0,52,41,93,0.0,0.5591397849462365,0.44086021505376344
50,Bamboozled,0,52,121,173,0.0,0.30057803468208094,0.6994219653179191
51,Barry Lyndon,0,9,71,80,0.0,0.1125,0.8875
52,Barton Fink,0,24,128,152,0.0,0.15789473684210525,0.8421052631578947
53,Basic,0,93,132,225,0.0,0.41333333333333333,0.5866666666666667
54,Basic Instinct,0,116,72,188,0.0,0.6170212765957447,0.3829787234042553
55,Basquiat,0,26,95,121,0.0,0.21487603305785125,0.7851239669421488
56,Batman,0,69,36,105,0.0,0.6571428571428571,0.34285714285714286
57,Batman And Robin,0,18,88,106,0.0,0.16981132075471697,0.8301886792452831
58,Batman Forever,0,32,61,93,0.0,0.34408602150537637,0.6559139784946236
59,Batman Returns,0,26,57,83,0.0,0.3132530120481928,0.6867469879518072
60,Bean,0,23,65,88,0.0,0.26136363636363635,0.7386363636363636
61,Beavis And Butt-Head Do America,0,0,107,107,0.0,0.0,1.0
62,Beetle Juice,17,140,23,180,0.09444444444444444,0.7777777777777778,0.12777777777777777
63,Being John Malkovich,10,86,41,137,0.072992700729927,0.6277372262773723,0.29927007299270075
64,Being There,4,81,95,180,0.022222222222222223,0.45,0.5277777777777778
65,Beloved,5,32,17,54,0.09259259259259259,0.5925925925925926,0.3148148148148148
66,Big Fish,6,62,62,130,0.046153846153846156,0.47692307692307695,0.47692307692307695
67,Birthday Girl,0,57,32,89,0.0,0.6404494382022472,0.3595505617977528
68,Black Rain,0,18,109,127,0.0,0.14173228346456693,0.8582677165354331
69,Black Snake Moan,0,90,49,139,0.0,0.6474820143884892,0.35251798561151076
70,Blade,0,66,34,100,0.0,0.66,0.34
71,Blade Ii,0,29,48,77,0.0,0.37662337662337664,0.6233766233766234
72,Blade Runner,0,51,94,145,0.0,0.35172413793103446,0.6482758620689655
73,Blast From The Past,0,169,74,243,0.0,0.6954732510288066,0.3045267489711934
74,Blood Simple.,0,41,50,91,0.0,0.45054945054945056,0.5494505494505495
75,Bloodmoon,0,52,110,162,0.0,0.32098765432098764,0.6790123456790124
76,Blow,0,43,129,172,0.0,0.25,0.75
77,Blue Velvet,0,102,57,159,0.0,0.6415094339622641,0.3584905660377358
78,Body Of Evidence,0,92,98,190,0.0,0.4842105263157895,0.5157894736842106
79,Bones,0,27,94,121,0.0,0.2231404958677686,0.7768595041322314
80,Book Of Shadows: Blair Witch 2,11,126,62,199,0.05527638190954774,0.6331658291457286,0.31155778894472363
81,Bottle Rocket,0,0,269,269,0.0,0.0,1.0
82,Bound,65,63,42,170,0.38235294117647056,0.37058823529411766,0.24705882352941178
83,Braveheart,0,35,48,83,0.0,0.42168674698795183,0.5783132530120482
84,Brazil,0,27,116,143,0.0,0.1888111888111888,0.8111888111888111
85,Bringing Out The Dead,0,25,90,115,0.0,0.21739130434782608,0.782608695652174
86,Broadcast News,0,120,76,196,0.0,0.6122448979591837,0.3877551020408163
87,Buffy The Vampire Slayer,43,108,38,189,0.2275132275132275,0.5714285714285714,0.20105820105820105
88,Bull Durham,0,80,70,150,0.0,0.5333333333333333,0.4666666666666667
89,Casablanca,0,69,151,220,0.0,0.31363636363636366,0.6863636363636364
90,Casino,0,112,226,338,0.0,0.33136094674556216,0.6686390532544378
91,Cast Away,0,35,94,129,0.0,0.2713178294573643,0.7286821705426356
92,Catwoman,7,43,64,114,0.06140350877192982,0.37719298245614036,0.5614035087719298
93,Cellular,0,78,71,149,0.0,0.5234899328859061,0.47651006711409394
94,Charade,0,13,166,179,0.0,0.07262569832402235,0.9273743016759777
95,Cherry Falls,22,51,35,108,0.2037037037037037,0.4722222222222222,0.32407407407407407
96,Chill Factor,0,0,225,225,0.0,0.0,1.0
97,Chinatown,0,67,121,188,0.0,0.35638297872340424,0.6436170212765957
98,Citizen Kane,37,98,51,186,0.1989247311827957,0.5268817204301075,0.27419354838709675
99,Clerks.,0,34,157,191,0.0,0.17801047120418848,0.8219895287958116
100,Cliffhanger,0,55,85,140,0.0,0.39285714285714285,0.6071428571428571
101,Collateral,0,15,125,140,0.0,0.10714285714285714,0.8928571428571429
102,Confidence,0,47,155,202,0.0,0.23267326732673269,0.7673267326732673
103,Conspiracy Theory,0,114,19,133,0.0,0.8571428571428571,0.14285714285714285
104,Contact,0,112,13,125,0.0,0.896,0.104
105,Cool Hand Luke,0,8,104,112,0.0,0.07142857142857142,0.9285714285714286
106,Copycat,37,114,9,160,0.23125,0.7125,0.05625
107,Crash,0,26,13,39,0.0,0.6666666666666666,0.3333333333333333
108,Crazy Love,51,132,3,186,0.27419354838709675,0.7096774193548387,0.016129032258064516
109,Crime Spree,0,22,156,178,0.0,0.12359550561797752,0.8764044943820225
110,Crouching Tiger Hidden Dragon,13,51,11,75,0.17333333333333334,0.68,0.14666666666666667
111,Croupier,0,67,60,127,0.0,0.5275590551181102,0.47244094488188976
112,Cruel Intentions,18,132,26,176,0.10227272727272728,0.75,0.14772727272727273
113,Dark Angel,0,15,112,127,0.0,0.11811023622047244,0.8818897637795275
114,Dark City,0,0,75,75,0.0,0.0,1.0
115,Dark Star,0,0,62,62,0.0,0.0,1.0
116,Dave,0,41,109,150,0.0,0.2733333333333333,0.7266666666666667
117,Day Of The Dead,0,16,42,58,0.0,0.27586206896551724,0.7241379310344828
118,Dead Poets Society,0,21,121,142,0.0,0.14788732394366197,0.852112676056338
119,Deep Rising,0,32,58,90,0.0,0.35555555555555557,0.6444444444444445
120,Demolition Man,0,0,99,99,0.0,0.0,1.0
121,Detroit Rock City,0,0,127,127,0.0,0.0,1.0
122,Die Hard,0,0,83,83,0.0,0.0,1.0
123,Do The Right Thing,0,28,110,138,0.0,0.2028985507246377,0.7971014492753623
124,Dog Day Afternoon,0,3,128,131,0.0,0.022900763358778626,0.9770992366412213
125,Domino,0,49,41,90,0.0,0.5444444444444444,0.45555555555555555
126,Donnie Darko,0,35,91,126,0.0,0.2777777777777778,0.7222222222222222
127,Dr. Strangelove Or: How I Learned To Stop Worrying And Love The Bomb,0,0,141,141,0.0,0.0,1.0
128,Drop Dead Gorgeous,32,25,31,88,0.36363636363636365,0.2840909090909091,0.3522727272727273
129,Duck Soup,0,0,70,70,0.0,0.0,1.0
130,Dumb And Dumberer: When Harry Met Lloyd,3,67,123,193,0.015544041450777202,0.3471502590673575,0.6373056994818653
131,Dune,0,12,58,70,0.0,0.17142857142857143,0.8285714285714286
132,Ed Wood,0,45,175,220,0.0,0.20454545454545456,0.7954545454545454
133,Edtv,0,62,87,149,0.0,0.4161073825503356,0.5838926174496645
134,Election,0,52,49,101,0.0,0.5148514851485149,0.48514851485148514
135,Enemy Of The State,0,12,134,146,0.0,0.0821917808219178,0.9178082191780822
136,Entrapment,0,168,23,191,0.0,0.8795811518324608,0.12041884816753927
137,Erik The Viking,0,38,137,175,0.0,0.21714285714285714,0.7828571428571428
138,Erin Brockovich,17,177,15,209,0.08133971291866028,0.84688995215311,0.07177033492822966
139,Escape From L.A.,0,0,83,83,0.0,0.0,1.0
140,Escape From The Planet Of The Apes,0,0,16,16,0.0,0.0,1.0
141,Eternal Sunshine Of The Spotless Mind,3,145,57,205,0.014634146341463415,0.7073170731707317,0.2780487804878049
142,Even Cowgirls Get The Blues,10,28,3,41,0.24390243902439024,0.6829268292682927,0.07317073170731707
143,Event Horizon,6,88,118,212,0.02830188679245283,0.41509433962264153,0.5566037735849056
144,Excalibur,0,0,93,93,0.0,0.0,1.0
145,Face/Off,0,30,72,102,0.0,0.29411764705882354,0.7058823529411765
146,Fantastic Four,0,71,99,170,0.0,0.4176470588235294,0.5823529411764706
147,Fantastic Voyage,0,32,112,144,0.0,0.2222222222222222,0.7777777777777778
148,Fargo,0,62,71,133,0.0,0.46616541353383456,0.5338345864661654
149,Fast Times At Ridgemont High,30,70,72,172,0.1744186046511628,0.4069767441860465,0.4186046511627907
150,Fear And Loathing In Las Vegas,0,12,105,117,0.0,0.10256410256410256,0.8974358974358975
151,Feast,0,84,51,135,0.0,0.6222222222222222,0.37777777777777777
152,Fight Club,0,47,141,188,0.0,0.25,0.75
153,Final Destination,0,32,26,58,0.0,0.5517241379310345,0.4482758620689655
154,Final Destination 2,18,57,24,99,0.18181818181818182,0.5757575757575758,0.24242424242424243
155,Five Easy Pieces,0,111,38,149,0.0,0.7449664429530202,0.2550335570469799
156,Five Feet High And Rising,0,10,31,41,0.0,0.24390243902439024,0.7560975609756098
157,Fletch,0,50,99,149,0.0,0.33557046979865773,0.6644295302013423
158,Frances,26,128,9,163,0.15950920245398773,0.7852760736196319,0.05521472392638037
159,Frankenstein,0,31,60,91,0.0,0.34065934065934067,0.6593406593406593
160,Freddy Vs. Jason,0,0,68,68,0.0,0.0,1.0
161,Frequency,0,23,117,140,0.0,0.16428571428571428,0.8357142857142857
162,Friday The 13Th,0,44,50,94,0.0,0.46808510638297873,0.5319148936170213
163,Friday The 13Th Part Iii,5,48,16,69,0.07246376811594203,0.6956521739130435,0.2318840579710145
164,Friday The 13Th Part Viii: Jason Takes Manhattan,19,40,20,79,0.24050632911392406,0.5063291139240507,0.25316455696202533
165,From Dusk Till Dawn,0,27,86,113,0.0,0.23893805309734514,0.7610619469026548
166,G.I. Jane,9,102,16,127,0.07086614173228346,0.8031496062992126,0.12598425196850394
167,Galaxy Quest,0,75,128,203,0.0,0.3694581280788177,0.6305418719211823
168,Game 6,0,55,63,118,0.0,0.4661016949152542,0.5338983050847458
169,Gandhi,0,0,88,88,0.0,0.0,1.0
170,Gattaca,0,23,87,110,0.0,0.20909090909090908,0.7909090909090909
171,George Washington,0,29,116,145,0.0,0.2,0.8
172,Get Carter,0,40,73,113,0.0,0.35398230088495575,0.6460176991150443
173,Get Shorty,0,49,157,206,0.0,0.23786407766990292,0.7621359223300971
174,Ghost Ship,0,84,111,195,0.0,0.4307692307692308,0.5692307692307692
175,Ghost World,93,106,15,214,0.43457943925233644,0.4953271028037383,0.07009345794392523
176,Ghostbusters,0,26,92,118,0.0,0.22033898305084745,0.7796610169491526
177,Ghostbusters Ii,0,53,111,164,0.0,0.3231707317073171,0.676829268292683
178,Gladiator,0,39,75,114,0.0,0.34210526315789475,0.6578947368421053
179,Glengarry Glen Ross,0,0,185,185,0.0,0.0,1.0
180,Gods And Monsters,0,44,141,185,0.0,0.23783783783783785,0.7621621621621621
181,Godzilla,0,50,50,100,0.0,0.5,0.5
182,Gone In Sixty Seconds,0,33,168,201,0.0,0.16417910447761194,0.835820895522388
183,Good Will Hunting,0,40,155,195,0.0,0.20512820512820512,0.7948717948717948
184,Goodfellas,0,31,45,76,0.0,0.40789473684210525,0.5921052631578947
185,Grand Hotel,10,76,103,189,0.05291005291005291,0.4021164021164021,0.544973544973545
186,Grosse Pointe Blank,0,40,66,106,0.0,0.37735849056603776,0.6226415094339622
187,Hackers,0,49,84,133,0.0,0.3684210526315789,0.631578947368421
188,Halloween,18,50,13,81,0.2222222222222222,0.6172839506172839,0.16049382716049382
189,Halloween 4: The Return Of Michael Myers,18,30,52,100,0.18,0.3,0.52
190,Halloween H20: 20 Years Later,0,34,35,69,0.0,0.4927536231884058,0.5072463768115942
191,Halloween Iii: Season Of The Witch,0,17,120,137,0.0,0.12408759124087591,0.8759124087591241
192,Halloween: The Curse Of Michael Myers,0,0,61,61,0.0,0.0,1.0
193,Hannah And Her Sisters,88,176,25,289,0.3044982698961938,0.6089965397923875,0.08650519031141868
194,Hannibal,0,74,49,123,0.0,0.6016260162601627,0.3983739837398374
195,Happy Birthday Wanda June,0,84,102,186,0.0,0.45161290322580644,0.5483870967741935
196,Happy Campers,0,35,37,72,0.0,0.4861111111111111,0.5138888888888888
197,Hardcore,0,39,63,102,0.0,0.38235294117647056,0.6176470588235294
198,Harold And Maude,0,73,39,112,0.0,0.6517857142857143,0.3482142857142857
199,Heathers,0,134,14,148,0.0,0.9054054054054054,0.0945945945945946
200,Heavenly Creatures,52,14,0,66,0.7878787878787878,0.21212121212121213,0.0
201,Hellbound: Hellraiser Ii,0,30,9,39,0.0,0.7692307692307693,0.23076923076923078
202,Hellboy,0,0,94,94,0.0,0.0,1.0
203,Hellraiser,5,130,7,142,0.035211267605633804,0.9154929577464789,0.04929577464788732
204,Hellraiser Iii: Hell On Earth,28,30,7,65,0.4307692307692308,0.46153846153846156,0.1076923076923077
205,Hellraiser: Hellseeker,0,32,61,93,0.0,0.34408602150537637,0.6559139784946236
206,Hero,0,49,49,98,0.0,0.5,0.5
207,Hider In The House,0,64,35,99,0.0,0.6464646464646465,0.35353535353535354
208,High Fidelity,0,91,82,173,0.0,0.5260115606936416,0.47398843930635837
209,Highlander,0,66,88,154,0.0,0.42857142857142855,0.5714285714285714
210,Highlander Iii: The Sorcerer,0,40,73,113,0.0,0.35398230088495575,0.6460176991150443
211,His Girl Friday,0,170,139,309,0.0,0.5501618122977346,0.44983818770226536
212,Hope And Glory,14,48,42,104,0.1346153846153846,0.46153846153846156,0.40384615384615385
213,Hostage,0,0,163,163,0.0,0.0,1.0
214,Hotel Rwanda,0,41,113,154,0.0,0.2662337662337662,0.7337662337662337
215,House Of 1000 Corpses,22,92,70,184,0.11956521739130435,0.5,0.3804347826086957
216,House Of The Damned,15,68,40,123,0.12195121951219512,0.5528455284552846,0.3252032520325203
217,House On Haunted Hill,0,87,76,163,0.0,0.5337423312883436,0.4662576687116564
218,Hudson Hawk,0,40,100,140,0.0,0.2857142857142857,0.7142857142857143
219,Human Nature,0,93,23,116,0.0,0.8017241379310345,0.19827586206896552
220,I Am Legend,0,21,8,29,0.0,0.7241379310344828,0.27586206896551724
221,I Still Know What You Did Last Summer,39,70,26,135,0.28888888888888886,0.5185185185185185,0.1925925925925926
222,I Walked With A Zombie,15,52,9,76,0.19736842105263158,0.6842105263157895,0.11842105263157894
223,Independence Day,0,31,84,115,0.0,0.26956521739130435,0.7304347826086957
224,Indiana Jones And The Last Crusade,0,28,101,129,0.0,0.21705426356589147,0.7829457364341085
225,Indiana Jones And The Temple Of Doom,0,84,54,138,0.0,0.6086956521739131,0.391304347826087
226,Innerspace,0,79,221,300,0.0,0.2633333333333333,0.7366666666666667
227,Insomnia,0,29,63,92,0.0,0.31521739130434784,0.6847826086956522
228,Interview With The Vampire: The Vampire Chronicles,0,56,96,152,0.0,0.3684210526315789,0.631578947368421
229,Intolerable Cruelty,18,90,64,172,0.10465116279069768,0.5232558139534884,0.37209302325581395
230,Invaders From Mars,0,23,33,56,0.0,0.4107142857142857,0.5892857142857143
231,Isle Of The Dead,10,35,47,92,0.10869565217391304,0.3804347826086957,0.5108695652173914
232,It Happened One Night,14,106,46,166,0.08433734939759036,0.6385542168674698,0.27710843373493976
233,It'S A Wonderful Life,0,44,143,187,0.0,0.23529411764705882,0.7647058823529411
234,Jackie Brown,10,170,73,253,0.039525691699604744,0.6719367588932806,0.2885375494071146
235,Jacob'S Ladder,0,52,93,145,0.0,0.3586206896551724,0.6413793103448275
236,Jason Goes To Hell: The Final Friday,0,0,46,46,0.0,0.0,1.0
237,Jason Lives: Friday The 13Th Part Vi,0,0,72,72,0.0,0.0,1.0
238,Jason X,0,21,183,204,0.0,0.10294117647058823,0.8970588235294118
239,Jaws,0,22,114,136,0.0,0.16176470588235295,0.8382352941176471
240,Jaws 2,0,38,169,207,0.0,0.18357487922705315,0.8164251207729468
241,Jaws 3-D,0,101,34,135,0.0,0.7481481481481481,0.2518518518518518
242,Jaws: The Revenge,9,107,91,207,0.043478260869565216,0.5169082125603864,0.4396135265700483
243,Jennifer Eight,0,35,110,145,0.0,0.2413793103448276,0.7586206896551724
244,Jerry Maguire,13,77,96,186,0.06989247311827956,0.41397849462365593,0.5161290322580645
245,Jfk,0,39,146,185,0.0,0.21081081081081082,0.7891891891891892
246,Juno,74,86,5,165,0.4484848484848485,0.5212121212121212,0.030303030303030304
247,Jurassic Park,0,106,80,186,0.0,0.5698924731182796,0.43010752688172044
248,Jurassic Park Iii,0,45,59,104,0.0,0.4326923076923077,0.5673076923076923
249,Kafka,0,27,74,101,0.0,0.26732673267326734,0.7326732673267327
250,Kalifornia,20,68,28,116,0.1724137931034483,0.5862068965517241,0.2413793103448276
251,Kids,11,51,62,124,0.08870967741935484,0.4112903225806452,0.5
252,King Kong,0,29,24,53,0.0,0.5471698113207547,0.4528301886792453
253,Klute,0,68,29,97,0.0,0.7010309278350515,0.29896907216494845
254,Knight Moves,0,87,112,199,0.0,0.4371859296482412,0.5628140703517588
255,Kramer Vs. Kramer,0,58,96,154,0.0,0.37662337662337664,0.6233766233766234
256,Krull,0,27,106,133,0.0,0.20300751879699247,0.7969924812030075
257,Kundun,0,0,93,93,0.0,0.0,1.0
258,L'Avventura,14,71,52,137,0.10218978102189781,0.5182481751824818,0.3795620437956204
259,L.A. Confidential,0,26,132,158,0.0,0.16455696202531644,0.8354430379746836
260,La Battaglia Di Algeri,0,0,37,37,0.0,0.0,1.0
261,Labor Of Love,0,39,72,111,0.0,0.35135135135135137,0.6486486486486487
262,Lake Placid,0,113,69,182,0.0,0.6208791208791209,0.3791208791208791
263,Last Of The Mohicans,0,34,64,98,0.0,0.3469387755102041,0.6530612244897959
264,Le Grand Bleu,8,84,62,154,0.05194805194805195,0.5454545454545454,0.4025974025974026
265,Leaving Las Vegas,0,71,3,74,0.0,0.9594594594594594,0.04054054054054054
266,Legally Blonde,36,112,17,165,0.21818181818181817,0.6787878787878788,0.10303030303030303
267,Legend,0,46,135,181,0.0,0.2541436464088398,0.7458563535911602
268,Leviathan,0,39,90,129,0.0,0.3023255813953488,0.6976744186046512
269,Life As A House,3,127,107,237,0.012658227848101266,0.5358649789029536,0.45147679324894513
270,Little Nicky,0,39,110,149,0.0,0.26174496644295303,0.738255033557047
271,Lock Stock And Two Smoking Barrels,0,0,129,129,0.0,0.0,1.0
272,Logan'S Run,0,57,55,112,0.0,0.5089285714285714,0.49107142857142855
273,Lone Star,3,56,124,183,0.01639344262295082,0.30601092896174864,0.6775956284153005
274,Lord Of Illusions,0,40,95,135,0.0,0.2962962962962963,0.7037037037037037
275,Lost Highway,0,57,85,142,0.0,0.4014084507042254,0.5985915492957746
276,Lost Horizon,0,12,144,156,0.0,0.07692307692307693,0.9230769230769231
277,Lost In Translation,0,67,12,79,0.0,0.8481012658227848,0.1518987341772152
278,Lost Souls,0,85,32,117,0.0,0.7264957264957265,0.27350427350427353
279,Love & Basketball,43,106,18,167,0.25748502994011974,0.6347305389221557,0.10778443113772455
280,Léon,0,60,16,76,0.0,0.7894736842105263,0.21052631578947367
281,Made,0,9,167,176,0.0,0.05113636363636364,0.9488636363636364
282,Magnolia,0,75,117,192,0.0,0.390625,0.609375
283,Malcolm X,0,22,124,146,0.0,0.1506849315068493,0.8493150684931506
284,Man On Fire,8,58,90,156,0.05128205128205128,0.3717948717948718,0.5769230769230769
285,Man On The Moon,0,21,101,122,0.0,0.1721311475409836,0.8278688524590164
286,Manhunt,0,11,76,87,0.0,0.12643678160919541,0.8735632183908046
287,Manhunter,0,38,106,144,0.0,0.2638888888888889,0.7361111111111112
288,Maniac,0,0,32,32,0.0,0.0,1.0
289,Marty,16,53,51,120,0.13333333333333333,0.44166666666666665,0.425
290,Mash,0,0,204,204,0.0,0.0,1.0
291,Meet Joe Black,7,120,174,301,0.023255813953488372,0.39867109634551495,0.5780730897009967
292,Meet John Doe,3,66,77,146,0.02054794520547945,0.4520547945205479,0.5273972602739726
293,Memento,6,41,89,136,0.04411764705882353,0.3014705882352941,0.6544117647058824
294,Men In Black,0,20,109,129,0.0,0.15503875968992248,0.8449612403100775
295,Metro,0,30,119,149,0.0,0.20134228187919462,0.7986577181208053
296,Metropolis,0,16,76,92,0.0,0.17391304347826086,0.8260869565217391
297,Miami Vice,0,38,105,143,0.0,0.26573426573426573,0.7342657342657343
298,Midnight Cowboy,0,0,71,71,0.0,0.0,1.0
299,Midnight Express,0,0,87,87,0.0,0.0,1.0
300,Mighty Morphin Power Rangers,0,0,90,90,0.0,0.0,1.0
301,Mimic,0,57,35,92,0.0,0.6195652173913043,0.3804347826086957
302,Minority Report,0,51,146,197,0.0,0.25888324873096447,0.7411167512690355
303,Misery,0,92,3,95,0.0,0.968421052631579,0.031578947368421054
304,Mission: Impossible,0,39,71,110,0.0,0.35454545454545455,0.6454545454545455
305,Mission: Impossible Ii,0,54,71,125,0.0,0.432,0.568
306,Mobsters,0,0,129,129,0.0,0.0,1.0
307,Monkeybone,0,36,59,95,0.0,0.37894736842105264,0.6210526315789474
308,Monty Python And The Holy Grail,0,0,129,129,0.0,0.0,1.0
309,Moonstruck,15,98,32,145,0.10344827586206896,0.6758620689655173,0.2206896551724138
310,Mr. Deeds Goes To Town,8,57,156,221,0.03619909502262444,0.2579185520361991,0.7058823529411765
311,Mr. Smith Goes To Washington,0,78,116,194,0.0,0.4020618556701031,0.5979381443298969
312,Mrs Brown,0,50,64,114,0.0,0.43859649122807015,0.5614035087719298
313,Mulholland Dr.,36,21,22,79,0.45569620253164556,0.26582278481012656,0.27848101265822783
314,Mumford,0,77,111,188,0.0,0.4095744680851064,0.5904255319148937
315,My Best Friend'S Wedding,38,142,12,192,0.19791666666666666,0.7395833333333334,0.0625
316,My Girl,29,124,8,161,0.18012422360248448,0.7701863354037267,0.049689440993788817
317,My Girl 2,15,151,10,176,0.08522727272727272,0.8579545454545454,0.056818181818181816
318,My Mother Dreams The Satan'S Disciples In New York,12,13,0,25,0.48,0.52,0.0
319,Mystery Men,0,25,126,151,0.0,0.16556291390728478,0.8344370860927153
320,Mystery Of The Wax Museum,6,46,18,70,0.08571428571428572,0.6571428571428571,0.2571428571428571
321,Napoleon,0,22,75,97,0.0,0.2268041237113402,0.7731958762886598
322,Nashville,0,23,95,118,0.0,0.19491525423728814,0.8050847457627118
323,Natural Born Killers,0,0,105,105,0.0,0.0,1.0
324,Neuromancer,0,45,77,122,0.0,0.36885245901639346,0.6311475409836066
325,Never Been Kissed,35,86,18,139,0.2517985611510791,0.6187050359712231,0.12949640287769784
326,New Nightmare,0,91,0,91,0.0,1.0,0.0
327,Next Friday,0,12,154,166,0.0,0.07228915662650602,0.927710843373494
328,Nick Of Time,0,19,101,120,0.0,0.15833333333333333,0.8416666666666667
329,Ninotchka,17,139,83,239,0.07112970711297072,0.5815899581589958,0.3472803347280335
330,Nixon,0,29,239,268,0.0,0.10820895522388059,0.8917910447761194
331,No Country For Old Men,0,24,104,128,0.0,0.1875,0.8125
332,Nothing But A Man,0,60,66,126,0.0,0.47619047619047616,0.5238095238095238
333,Notting Hill,0,92,87,179,0.0,0.5139664804469274,0.4860335195530726
334,Nuovo Cinema Paradiso,0,16,42,58,0.0,0.27586206896551724,0.7241379310344828
335,Nurse Betty,49,71,103,223,0.21973094170403587,0.3183856502242152,0.4618834080717489
336,O Brother Where Art Thou?,0,8,98,106,0.0,0.07547169811320754,0.9245283018867925
337,On The Waterfront,0,50,83,133,0.0,0.37593984962406013,0.6240601503759399
338,One Flew Over The Cuckoo'S Nest,0,61,152,213,0.0,0.2863849765258216,0.7136150234741784
339,Only You,75,131,2,208,0.3605769230769231,0.6298076923076923,0.009615384615384616
340,Orgy Of The Dead,0,25,9,34,0.0,0.7352941176470589,0.2647058823529412
341,Out Of Sight,10,102,129,241,0.04149377593360996,0.42323651452282157,0.5352697095435685
342,Panic Room,29,15,61,105,0.2761904761904762,0.14285714285714285,0.580952380952381
343,Panther,0,0,110,110,0.0,0.0,1.0
344,Pearl Harbor,0,24,73,97,0.0,0.24742268041237114,0.7525773195876289
345,Peggy Sue Got Married,38,140,11,189,0.20105820105820105,0.7407407407407407,0.0582010582010582
346,Pet Sematary,8,55,49,112,0.07142857142857142,0.49107142857142855,0.4375
347,Pet Sematary Ii,0,0,61,61,0.0,0.0,1.0
348,Philadelphia,0,15,142,157,0.0,0.09554140127388536,0.9044585987261147
349,Pirates Of The Caribbean,0,55,103,158,0.0,0.34810126582278483,0.6518987341772152
350,Pitch Black,0,95,56,151,0.0,0.6291390728476821,0.3708609271523179
351,Planet Of The Apes,0,0,134,134,0.0,0.0,1.0
352,Plastic Man,0,93,61,154,0.0,0.6038961038961039,0.3961038961038961
353,Platinum Blonde,3,94,81,178,0.016853932584269662,0.5280898876404494,0.4550561797752809
354,Platoon,0,0,77,77,0.0,0.0,1.0
355,Playback,0,82,104,186,0.0,0.44086021505376344,0.5591397849462365
356,Pleasantville,8,113,76,197,0.04060913705583756,0.5736040609137056,0.38578680203045684
357,Point Break,0,17,79,96,0.0,0.17708333333333334,0.8229166666666666
358,Predator,0,0,38,38,0.0,0.0,1.0
359,Pretty Woman,15,106,39,160,0.09375,0.6625,0.24375
360,Psycho,0,70,45,115,0.0,0.6086956521739131,0.391304347826087
361,Punch-Drunk Love,8,49,58,115,0.06956521739130435,0.4260869565217391,0.5043478260869565
362,Quantum Project,0,15,5,20,0.0,0.75,0.25
363,Quills,0,58,74,132,0.0,0.4393939393939394,0.5606060606060606
364,Raging Bull,0,36,58,94,0.0,0.3829787234042553,0.6170212765957447
365,Rambling Rose,25,142,33,200,0.125,0.71,0.165
366,Rambo: First Blood Part Ii,0,16,74,90,0.0,0.17777777777777778,0.8222222222222222
367,Rear Window,0,108,36,144,0.0,0.75,0.25
368,Rebel Without A Cause,0,68,93,161,0.0,0.422360248447205,0.577639751552795
369,Red White Black & Blue,0,0,132,132,0.0,0.0,1.0
370,Reindeer Games,0,70,105,175,0.0,0.4,0.6
371,Reservoir Dogs,0,0,110,110,0.0,0.0,1.0
372,Rko 281,6,18,93,117,0.05128205128205128,0.15384615384615385,0.7948717948717948
373,Rocky,0,45,112,157,0.0,0.28662420382165604,0.7133757961783439
374,Romeo And Juliet,4,22,28,54,0.07407407407407407,0.4074074074074074,0.5185185185185185
375,Ronin,0,43,105,148,0.0,0.2905405405405405,0.7094594594594594
376,Roughshod,14,93,61,168,0.08333333333333333,0.5535714285714286,0.3630952380952381
377,Route 9,0,45,142,187,0.0,0.24064171122994651,0.7593582887700535
378,Runaway Bride,18,86,44,148,0.12162162162162163,0.581081081081081,0.2972972972972973
379,Rush Hour,0,16,82,98,0.0,0.16326530612244897,0.8367346938775511
380,Rush Hour 2,0,16,113,129,0.0,0.12403100775193798,0.875968992248062
381,Salt Of The Earth,0,40,32,72,0.0,0.5555555555555556,0.4444444444444444
382,Saving Private Ryan,0,0,152,152,0.0,0.0,1.0
383,Say Anything...,0,89,49,138,0.0,0.644927536231884,0.35507246376811596
384,Scary Movie 2,0,88,60,148,0.0,0.5945945945945946,0.40540540540540543
385,Schindler'S List,0,0,80,80,0.0,0.0,1.0
386,Scream,32,121,56,209,0.15311004784688995,0.5789473684210527,0.2679425837320574
387,Scream 2,19,77,48,144,0.13194444444444445,0.5347222222222222,0.3333333333333333
388,Scream 3,17,65,30,112,0.15178571428571427,0.5803571428571429,0.26785714285714285
389,Serial Mom,13,55,44,112,0.11607142857142858,0.49107142857142855,0.39285714285714285
390,Seven,0,14,140,154,0.0,0.09090909090909091,0.9090909090909091
391,Seven Days To Live,0,62,10,72,0.0,0.8611111111111112,0.1388888888888889
392,Sex Lies And Videotape,16,114,15,145,0.1103448275862069,0.7862068965517242,0.10344827586206896
393,Shakespeare In Love,0,44,98,142,0.0,0.30985915492957744,0.6901408450704225
394,Shallow Grave,0,76,62,138,0.0,0.5507246376811594,0.4492753623188406
395,Shampoo,7,184,64,255,0.027450980392156862,0.7215686274509804,0.25098039215686274
396,Shivers,0,0,41,41,0.0,0.0,1.0
397,Shock Treatment,0,18,84,102,0.0,0.17647058823529413,0.8235294117647058
398,Sideways,0,44,160,204,0.0,0.21568627450980393,0.7843137254901961
399,Signs,0,14,85,99,0.0,0.1414141414141414,0.8585858585858586
400,Silver Bullet,0,0,52,52,0.0,0.0,1.0
401,Silverado,0,18,108,126,0.0,0.14285714285714285,0.8571428571428571
402,Simone,0,48,86,134,0.0,0.3582089552238806,0.6417910447761194
403,Sister Act,34,111,92,237,0.14345991561181434,0.46835443037974683,0.3881856540084388
404,Slash,0,53,57,110,0.0,0.4818181818181818,0.5181818181818182
405,Sleepless In Seattle,26,56,73,155,0.16774193548387098,0.36129032258064514,0.47096774193548385
406,Sleepy Hollow,0,36,103,139,0.0,0.2589928057553957,0.7410071942446043
407,Sling Blade,0,49,91,140,0.0,0.35,0.65
408,Slither,12,33,28,73,0.1643835616438356,0.4520547945205479,0.3835616438356164
409,Smoke,0,24,80,104,0.0,0.23076923076923078,0.7692307692307693
410,Smokey And The Bandit,0,52,72,124,0.0,0.41935483870967744,0.5806451612903226
411,Smokin' Aces,14,4,85,103,0.13592233009708737,0.038834951456310676,0.8252427184466019
412,Snow Falling On Cedars,0,22,122,144,0.0,0.1527777777777778,0.8472222222222222
413,Solaris,0,51,43,94,0.0,0.5425531914893617,0.4574468085106383
414,Soldier,0,0,3,3,0.0,0.0,1.0
415,Some Like It Hot,0,94,137,231,0.0,0.4069264069264069,0.5930735930735931
416,Someone To Watch Over Me,0,94,34,128,0.0,0.734375,0.265625
417,Sounder,0,65,53,118,0.0,0.5508474576271186,0.4491525423728814
418,South Park: Bigger Longer & Uncut,0,0,212,212,0.0,0.0,1.0
419,Spacejacked,0,52,78,130,0.0,0.4,0.6
420,Spare Me,0,37,91,128,0.0,0.2890625,0.7109375
421,Sphere,0,103,173,276,0.0,0.37318840579710144,0.6268115942028986
422,Spider-Man,2,44,74,120,0.016666666666666666,0.36666666666666664,0.6166666666666667
423,Stalag 17,0,0,180,180,0.0,0.0,1.0
424,Star Trek Iii: The Search For Spock,0,30,99,129,0.0,0.23255813953488372,0.7674418604651163
425,Star Trek Iv: The Voyage Home,0,40,136,176,0.0,0.22727272727272727,0.7727272727272727
426,Star Trek V: The Final Frontier,0,0,106,106,0.0,0.0,1.0
427,Star Trek Vi: The Undiscovered Country,0,0,182,182,0.0,0.0,1.0
428,Star Trek: First Contact,0,41,105,146,0.0,0.2808219178082192,0.7191780821917808
429,Star Trek: Generations,0,10,108,118,0.0,0.0847457627118644,0.9152542372881356
430,Star Trek: Insurrection,0,37,116,153,0.0,0.24183006535947713,0.7581699346405228
431,Star Trek: Nemesis,0,31,155,186,0.0,0.16666666666666666,0.8333333333333334
432,Star Trek: The Motion Picture,0,0,130,130,0.0,0.0,1.0
433,Star Trek: The Wrath Of Khan,0,50,162,212,0.0,0.2358490566037736,0.7641509433962265
434,Star Wars,0,0,96,96,0.0,0.0,1.0
435,Star Wars: Episode Vi - Return Of The Jedi,0,0,91,91,0.0,0.0,1.0
436,Star Wars: The Empire Strikes Back,0,91,93,184,0.0,0.4945652173913043,0.5054347826086957
437,Starman,0,120,52,172,0.0,0.6976744186046512,0.3023255813953488
438,Starship Troopers,0,88,98,186,0.0,0.4731182795698925,0.5268817204301075
439,State And Main,0,102,135,237,0.0,0.43037974683544306,0.569620253164557
440,Stepmom,149,122,0,271,0.5498154981549815,0.45018450184501846,0.0
441,Storytelling,0,29,55,84,0.0,0.34523809523809523,0.6547619047619048
442,Strange Days,0,102,49,151,0.0,0.6754966887417219,0.32450331125827814
443,Stranglehold,0,0,58,58,0.0,0.0,1.0
444,Suburbia,6,96,114,216,0.027777777777777776,0.4444444444444444,0.5277777777777778
445,Sugar & Spice,31,54,0,85,0.36470588235294116,0.6352941176470588,0.0
446,Sunset Blvd.,1,91,41,133,0.007518796992481203,0.6842105263157895,0.3082706766917293
447,Supergirl,42,99,12,153,0.27450980392156865,0.6470588235294118,0.0784313725490196
448,Superman,0,66,56,122,0.0,0.5409836065573771,0.45901639344262296
449,Superman Ii,0,43,52,95,0.0,0.45263157894736844,0.5473684210526316
450,Superman Iii,0,60,92,152,0.0,0.39473684210526316,0.6052631578947368
451,Superman Iv: The Quest For Peace,0,36,52,88,0.0,0.4090909090909091,0.5909090909090909
452,Suspect Zero,0,43,88,131,0.0,0.3282442748091603,0.6717557251908397
453,Sweet Smell Of Success,0,62,98,160,0.0,0.3875,0.6125
454,Swingers,0,11,166,177,0.0,0.062146892655367235,0.9378531073446328
455,Taking Sides,0,13,72,85,0.0,0.15294117647058825,0.8470588235294118
456,Taxi Driver,0,46,46,92,0.0,0.5,0.5
457,Terminator 2: Judgment Day,0,36,51,87,0.0,0.41379310344827586,0.5862068965517241
458,The Abyss,0,80,48,128,0.0,0.625,0.375
459,The Adventures Of Buckaroo Banzai Across The 8Th Dimension,0,20,69,89,0.0,0.2247191011235955,0.7752808988764045
460,The Adventures Of Ford Fairlane,0,75,58,133,0.0,0.5639097744360902,0.43609022556390975
461,The Anniversary Party,30,119,18,167,0.17964071856287425,0.7125748502994012,0.10778443113772455
462,The Apartment,0,99,86,185,0.0,0.5351351351351351,0.4648648648648649
463,The Atomic Submarine,0,0,76,76,0.0,0.0,1.0
464,The Avengers,8,109,22,139,0.05755395683453238,0.7841726618705036,0.15827338129496402
465,The Beach,0,0,35,35,0.0,0.0,1.0
466,The Believer,0,37,108,145,0.0,0.25517241379310346,0.7448275862068966
467,The Big Lebowski,0,19,181,200,0.0,0.095,0.905
468,The Birds,41,88,43,172,0.23837209302325582,0.5116279069767442,0.25
469,The Black Dahlia,0,0,3,3,0.0,0.0,1.0
470,The Body Snatcher,0,11,86,97,0.0,0.1134020618556701,0.8865979381443299
471,The Boondock Saints,0,0,161,161,0.0,0.0,1.0
472,The Bourne Identity,0,44,47,91,0.0,0.4835164835164835,0.5164835164835165
473,The Bourne Supremacy,7,70,24,101,0.06930693069306931,0.693069306930693,0.2376237623762376
474,The Bridges Of Madison County,6,105,11,122,0.04918032786885246,0.860655737704918,0.09016393442622951
475,The Butterfly Effect,0,73,67,140,0.0,0.5214285714285715,0.4785714285714286
476,The Cell,19,48,18,85,0.2235294117647059,0.5647058823529412,0.21176470588235294
477,The Cider House Rules,6,83,104,193,0.031088082901554404,0.43005181347150256,0.538860103626943
478,The Crow,0,0,85,85,0.0,0.0,1.0
479,The Crow: Salvation,11,20,43,74,0.14864864864864866,0.2702702702702703,0.581081081081081
480,The Crying Game,0,36,205,241,0.0,0.14937759336099585,0.8506224066390041
481,The Curse,54,103,21,178,0.30337078651685395,0.5786516853932584,0.11797752808988764
482,The Curse Of The Cat People,48,67,12,127,0.3779527559055118,0.5275590551181102,0.09448818897637795
483,The Day The Earth Stood Still,0,45,49,94,0.0,0.4787234042553192,0.5212765957446809
484,The Deer Hunter,0,15,110,125,0.0,0.12,0.88
485,The Devil And Daniel Webster,0,59,98,157,0.0,0.37579617834394907,0.6242038216560509
486,The Elephant Man,0,25,94,119,0.0,0.21008403361344538,0.7899159663865546
487,The English Patient,0,119,51,170,0.0,0.7,0.3
488,The Exorcist,29,52,49,130,0.2230769230769231,0.4,0.3769230769230769
489,The Fabulous Baker Boys,0,90,155,245,0.0,0.3673469387755102,0.6326530612244898
490,The Family Man,4,90,102,196,0.02040816326530612,0.45918367346938777,0.5204081632653061
491,The Fantastic Four,0,71,99,170,0.0,0.4176470588235294,0.5823529411764706
492,The Fifth Element,0,25,114,139,0.0,0.17985611510791366,0.8201438848920863
493,The Fisher King,13,54,69,136,0.09558823529411764,0.39705882352941174,0.5073529411764706
494,The French Connection,0,0,83,83,0.0,0.0,1.0
495,The Game,0,80,73,153,0.0,0.5228758169934641,0.477124183006536
496,The Getaway,0,76,34,110,0.0,0.6909090909090909,0.3090909090909091
497,The Ghost And The Darkness,0,0,91,91,0.0,0.0,1.0
498,The Godfather,0,27,120,147,0.0,0.1836734693877551,0.8163265306122449
499,The Godfather: Part Ii,0,11,132,143,0.0,0.07692307692307693,0.9230769230769231
500,The Graduate,0,151,43,194,0.0,0.7783505154639175,0.22164948453608246
501,The Grapes Of Wrath,0,43,111,154,0.0,0.2792207792207792,0.7207792207792207
502,The Grifters,0,105,24,129,0.0,0.813953488372093,0.18604651162790697
503,The Haunting,31,57,23,111,0.27927927927927926,0.5135135135135135,0.2072072072072072
504,The Hebrew Hammer,0,27,56,83,0.0,0.3253012048192771,0.6746987951807228
505,The Horse Whisperer,60,131,24,215,0.27906976744186046,0.6093023255813953,0.11162790697674418
506,The Hudsucker Proxy,0,46,69,115,0.0,0.4,0.6
507,The Hustler,0,53,100,153,0.0,0.3464052287581699,0.6535947712418301
508,The Ice Storm,7,82,50,139,0.050359712230215826,0.5899280575539568,0.3597122302158273
509,The Insider,0,21,150,171,0.0,0.12280701754385964,0.8771929824561403
510,The Jacket,2,99,46,147,0.013605442176870748,0.673469387755102,0.3129251700680272
511,The Jazz Singer,0,0,1,1,0.0,0.0,1.0
512,The Leopard Man,0,39,66,105,0.0,0.37142857142857144,0.6285714285714286
513,The Life Of David Gale,0,0,181,181,0.0,0.0,1.0
514,The Limey,0,44,75,119,0.0,0.3697478991596639,0.6302521008403361
515,The Lost Boys,0,68,86,154,0.0,0.44155844155844154,0.5584415584415584
516,The Lost Son,0,89,75,164,0.0,0.5426829268292683,0.4573170731707317
517,The Lost World: Jurassic Park,0,44,58,102,0.0,0.43137254901960786,0.5686274509803921
518,The Magic Toyshop,0,35,0,35,0.0,1.0,0.0
519,The Majestic,0,40,106,146,0.0,0.273972602739726,0.726027397260274
520,The Man In The Iron Mask,0,0,142,142,0.0,0.0,1.0
521,The Man Who Wasn'T There,0,28,88,116,0.0,0.2413793103448276,0.7586206896551724
522,The Matrix,0,67,88,155,0.0,0.432258064516129,0.567741935483871
523,The Messenger,0,140,42,182,0.0,0.7692307692307693,0.23076923076923078
524,The Mummy,0,84,59,143,0.0,0.5874125874125874,0.4125874125874126
525,The Negotiator,0,0,9,9,0.0,0.0,1.0
526,The Night Of The Hunter,0,54,79,133,0.0,0.40601503759398494,0.5939849624060151
527,The Nightmare Before Christmas,0,13,17,30,0.0,0.43333333333333335,0.5666666666666667
528,The Patriot,0,0,108,108,0.0,0.0,1.0
529,The Pianist,0,0,77,77,0.0,0.0,1.0
530,The Piano,0,0,54,54,0.0,0.0,1.0
531,The Ploughman'S Lunch,0,42,44,86,0.0,0.4883720930232558,0.5116279069767442
532,The Princess Bride,0,32,127,159,0.0,0.20125786163522014,0.7987421383647799
533,The Producers,0,0,90,90,0.0,0.0,1.0
534,The Relic,0,64,81,145,0.0,0.4413793103448276,0.5586206896551724
535,The Rock,0,0,30,30,0.0,0.0,1.0
536,The Rocky Horror Picture Show,0,32,25,57,0.0,0.5614035087719298,0.43859649122807015
537,The Salton Sea,0,38,135,173,0.0,0.21965317919075145,0.7803468208092486
538,The Searchers,0,12,116,128,0.0,0.09375,0.90625
539,The Seventh Victim,6,81,51,138,0.043478260869565216,0.5869565217391305,0.3695652173913043
540,The Shining,0,83,82,165,0.0,0.503030303030303,0.49696969696969695
541,The Silence Of The Lambs,0,90,12,102,0.0,0.8823529411764706,0.11764705882352941
542,The Sixth Sense,0,20,71,91,0.0,0.21978021978021978,0.7802197802197802
543,The Sting,0,8,123,131,0.0,0.061068702290076333,0.9389312977099237
544,The Sweet Hereafter,0,90,57,147,0.0,0.6122448979591837,0.3877551020408163
545,The Talented Mr. Ripley,1,74,89,164,0.006097560975609756,0.45121951219512196,0.5426829268292683
546,The Terminator,0,55,21,76,0.0,0.7236842105263158,0.27631578947368424
547,The Thin Man,21,119,56,196,0.10714285714285714,0.6071428571428571,0.2857142857142857
548,The Thing,0,0,133,133,0.0,0.0,1.0
549,The Third Man,0,77,139,216,0.0,0.35648148148148145,0.6435185185185185
550,The Time Machine,0,53,99,152,0.0,0.34868421052631576,0.6513157894736842
551,The Truman Show,0,30,54,84,0.0,0.35714285714285715,0.6428571428571429
552,The Usual Suspects,0,0,118,118,0.0,0.0,1.0
553,The Verdict,0,28,105,133,0.0,0.21052631578947367,0.7894736842105263
554,The War Of The Worlds,0,31,31,62,0.0,0.5,0.5
555,The Wedding Date,0,106,27,133,0.0,0.7969924812030075,0.20300751879699247
556,The Witching Hour,0,15,146,161,0.0,0.09316770186335403,0.906832298136646
557,The Wizard Of Oz,10,118,75,203,0.04926108374384237,0.5812807881773399,0.3694581280788177
558,The Woodsman,0,79,70,149,0.0,0.5302013422818792,0.4697986577181208
559,The World Is Not Enough,0,66,43,109,0.0,0.6055045871559633,0.3944954128440367
560,The X Files,0,59,66,125,0.0,0.472,0.528
561,Thelma & Louise,100,60,19,179,0.5586592178770949,0.33519553072625696,0.10614525139664804
562,There'S Something About Mary,16,102,118,236,0.06779661016949153,0.4322033898305085,0.5
563,Thirteen Days,0,0,103,103,0.0,0.0,1.0
564,Three Kings,0,117,119,236,0.0,0.4957627118644068,0.5042372881355932
565,Thunderheart,0,0,139,139,0.0,0.0,1.0
566,Thx 1138,0,24,52,76,0.0,0.3157894736842105,0.6842105263157895
567,Ticker,0,0,122,122,0.0,0.0,1.0
568,Titanic,0,86,50,136,0.0,0.6323529411764706,0.36764705882352944
569,To Sleep With Anger,0,47,50,97,0.0,0.4845360824742268,0.5154639175257731
570,Tombstone,0,28,134,162,0.0,0.1728395061728395,0.8271604938271605
571,Tomorrow Never Dies,0,0,152,152,0.0,0.0,1.0
572,Top Gun,1,48,124,173,0.005780346820809248,0.2774566473988439,0.7167630057803468
573,Total Recall,0,52,91,143,0.0,0.36363636363636365,0.6363636363636364
574,Toy Story,0,16,135,151,0.0,0.10596026490066225,0.8940397350993378
575,Traffic,0,47,83,130,0.0,0.36153846153846153,0.6384615384615384
576,Trainspotting,0,10,61,71,0.0,0.14084507042253522,0.8591549295774648
577,Transatlantic Merry-Go-Round,2,78,98,178,0.011235955056179775,0.43820224719101125,0.550561797752809
578,Tremors,0,28,113,141,0.0,0.19858156028368795,0.8014184397163121
579,Tron,0,0,96,96,0.0,0.0,1.0
580,Trouble In Paradise,7,52,29,88,0.07954545454545454,0.5909090909090909,0.32954545454545453
581,True Believer,0,20,118,138,0.0,0.14492753623188406,0.855072463768116
582,True Lies,0,75,86,161,0.0,0.4658385093167702,0.5341614906832298
583,True Romance,0,57,113,170,0.0,0.3352941176470588,0.6647058823529411
584,Twelve Monkeys,0,50,46,96,0.0,0.5208333333333334,0.4791666666666667
585,Twin Peaks: Fire Walk With Me,21,47,81,149,0.14093959731543623,0.31543624161073824,0.5436241610738255
586,U Turn,0,80,89,169,0.0,0.47337278106508873,0.5266272189349113
587,U-Turn,0,78,92,170,0.0,0.4588235294117647,0.5411764705882353
588,Unbreakable,0,26,61,87,0.0,0.2988505747126437,0.7011494252873564
589,Unforgiven,0,29,115,144,0.0,0.2013888888888889,0.7986111111111112
590,Vampyr,0,0,8,8,0.0,0.0,1.0
591,Verdict,0,23,110,133,0.0,0.17293233082706766,0.8270676691729323
592,Vertigo,0,135,13,148,0.0,0.9121621621621622,0.08783783783783784
593,Very Bad Things,0,37,165,202,0.0,0.18316831683168316,0.8168316831683168
594,Viridiana,0,76,53,129,0.0,0.5891472868217055,0.4108527131782946
595,Virtuosity,0,56,62,118,0.0,0.4745762711864407,0.5254237288135594
596,Wag The Dog,0,70,129,199,0.0,0.35175879396984927,0.6482412060301508
597,Wall Street,0,28,111,139,0.0,0.2014388489208633,0.7985611510791367
598,Watchmen,1,59,53,113,0.008849557522123894,0.5221238938053098,0.4690265486725664
599,Waxwork,0,0,41,41,0.0,0.0,1.0
600,What Lies Beneath,48,119,0,167,0.2874251497005988,0.7125748502994012,0.0
601,What Women Want,0,0,1,1,0.0,0.0,1.0
602,White Angel,0,66,13,79,0.0,0.8354430379746836,0.16455696202531644
603,White Squall,0,0,175,175,0.0,0.0,1.0
604,Who Framed Roger Rabbit,0,33,78,111,0.0,0.2972972972972973,0.7027027027027027
605,Who'S Your Daddy?,0,62,110,172,0.0,0.36046511627906974,0.6395348837209303
606,Wild At Heart,5,126,50,181,0.027624309392265192,0.6961325966850829,0.27624309392265195
607,Wild Things,15,102,49,166,0.09036144578313253,0.6144578313253012,0.29518072289156627
608,Wild Wild West,0,14,97,111,0.0,0.12612612612612611,0.8738738738738738
609,Willow,0,30,92,122,0.0,0.2459016393442623,0.7540983606557377
610,Witness,0,52,45,97,0.0,0.5360824742268041,0.4639175257731959
611,Wonder Boys,0,58,174,232,0.0,0.25,0.75
612,X-Men,0,0,59,59,0.0,0.0,1.0
613,Xxx,0,34,71,105,0.0,0.3238095238095238,0.6761904761904762
614,Young Frankenstein,0,69,93,162,0.0,0.42592592592592593,0.5740740740740741
615,Zulu Dawn,0,0,23,23,0.0,0.0,1.0
